1111111111
1P000001E1
1000000011
1C00000001
1111111111
