1111111111111111111111111111111111111111111111
10000000000000000000C10000000000000000000000C1
1010000000000000000000000000000000000000000011
1010000000000000000000000000000000100000000001
1010000000000000000000000000000001C10000000001
10100000000C0000000000000000000000000000000001
1010000000010000000001111110000000000000000001
1010000100000000000000000000000000000000000001
1010000000000000000000000000000000000000000001
1010000010000000000PE0000000000000000000000001
1010C00000000000000000000000000000000000000001
10100000000010000000000110001100000000C0000001
1010000000000000000000100101001000000000000001
1010000000000C00000000100010001000000000000001
1010000000000000000000010000010000000000111101
1010001001000000000000001000100000000000000011
1010001001000000000000000101000000000000110001
10100010010000000000C0000010000000000000001001
1C100000000000000000000000000000000000000001C1
1111111111111111111111111111111111111111111111
