1111111111
1E000100C1
1000110001
1P00000001
1111111111
