11111111111111111111
1E00000000000000C001
10000000C00000000001
1000000000000000C001
1000000P000000000001
11111111111111111111
