1111111111
1E001000C1
1001C10001
1P00000001
1000000001
1111111111
