11111111111111111111111111111111111111111111111
10001000C00000000000001000001000000P000000000C1
1001C1000000000C0000000000000000000000001000001
100000000E000000001000100C000000001000000000001
10000000000010000000000000000100000000000010001
11111111111111111111111111111111111111111111111
