1111111111
oC00000001
10P0000E01
1111111111
